############################
#......##..........##......#
#o####.##.########.##.####o#
#.####.##.########.##.####.#
#..........................#
###.##.#####.##.#####.##.###
###.##.#####.##.#####.##.###
###.##.#####.##.#####.##.###
---.##.......##.......##.---
###.#####-########-#####.###
###.#####-########-#####.###
###.--------------------.###
###.#####-########-#####.###
###.#####-#      #-#####.###
###.##----#      #----##.###
###.##-##-#      #-##-##.###
###.##-##-########-##-##.###
---.---##----------##---.---
###.########-##-########.###
###.########-##-########.###
###..........##..........###
###.#####.########.#####.###
###.#####.########.#####.###
#..........................#
#.####.#####.##.#####.####.#
#.####.#####.##.#####.####.#
#.####.##....##....##.####.#
#o####.##.########.##.####o#
#.####.##.########.##.####.#
#..........................#
############################