  ############################  
  #------##----------##------#  
  #-####-##-########-##-####-#  
  #-####-##-########-##-####-#  
  #--------------------------#  
  ###-##-#####-##-#####-##-###  
  ###-##-#####-##-#####-##-###  
  ###-##-#####-##-#####-##-###  
T-----##-------##-------##-----T
  ###-#####-########-#####-###  
  ###-#####-########-#####-###  
  ###----------MM----------###  
  ###-#####-###mm###-#####-###  
  ###-#####-#  mm  #-#####-###  
  ###-##----# -mm- #----##-###  
  ###-##-##-#      #-##-##-###  
  ###-##-##-########-##-##-###  
T--------##----------##--------T
  ###-########-##-########-###  
  ###-########-##-########-###  
  ###----------##----------###  
  ###-#####-########-#####-###  
  ###-#####-########-#####-###  
  #--------------------------#  
  #-####-#####-##-#####-####-#  
  #-####-#####-##-#####-####-#  
  #-####-##----##----##-####-#  
  #-####-##-########-##-####-#  
  #-####-##-########-##-####-#  
  #------------..------------#  
  ############################  