{
  "levels": {
    "1": [
      "  ############################  ",
      "  #......##..........##......#  ",
      "  #o####.##.########.##.####o#  ",
      "  #.####.##.########.##.####.#  ",
      "  #..........................#  ",
      "  ###.##.#####.##.#####.##.###  ",
      "  ###.##.#####.##.#####.##.###  ",
      "  ###.##.#####.##.#####.##.###  ",
      "T----.##.......##.......##.----T",
      "  ###.#####-########-#####.###  ",
      "  ###.#####-########-#####.###  ",
      "  ###.---------mm---------.###  ",
      "  ###.#####-###MM###-#####.###  ",
      "  ###.#####-#  mm  #-#####.###  ",
      "  ###.##----# -mm- #----##.###  ",
      "  ###.##-##-#      #-##-##.###  ",
      "  ###.##-##-########-##-##.###  ",
      "T----.---##----mm----##---.----T",
      "  ###.########-##-########.###  ",
      "  ###.########-##-########.###  ",
      "  ###..........##..........###  ",
      "  ###.#####.########.#####.###  ",
      "  ###.#####.########.#####.###  ",
      "  #............mm............#  ",
      "  #.####.#####.##.#####.####.#  ",
      "  #.####.#####.##.#####.####.#  ",
      "  #.####.##....##....##.####.#  ",
      "  #o####.##.########.##.####o#  ",
      "  #.####.##.########.##.####.#  ",
      "  #..........................#  ",
      "  ############################  "
    ],
    "2": [
      "  ############################  ",
      "T--------##..........##--------T",
      "  ######-##.########.##-######  ",
      "  ######-##.########.##-######  ",
      "  #o...........##...........o#  ",
      "  #.#######.##.##.##.#######.#  ",
      "  #.#######.##.##.##.#######.#  ",
      "  #.##......##.##.##......##.#  ",
      "  #.##.####-##....##-####.##.#  ",
      "  #.##.####-########-####.##.#  ",
      "  #......##-########-##......#  ",
      "  ######.##----mm----##.######  ",
      "  ######.##-###MM###-##.######  ",
      "  #......##-#  mm  #-##......#  ",
      "  #.####.##-# -mm- #-##.####.#  ",
      "  #.####.---#      #---.####.#  ",
      "  #...##.##-########-##.##...#  ",
      "  ###.##.##----mm----##.##.###  ",
      "  ###.##.####-####-####.##.###  ",
      "  ###.##.####-####-####.##.###  ",
      "  ###.........####.........###  ",
      "  ###.#######.####.#######.###  ",
      "  ###.#######.####.#######.###  ",
      "T----....##...-mm-...##....----T",
      "  ###.##.##.########.##.##.###  ",
      "  ###.##.##.########.##.##.###  ",
      "  #o..##.......##.......##..o#  ",
      "  #.####.#####.##.#####.####.#  ",
      "  #.####.#####.##.#####.####.#  ",
      "  #..........................#  ",
      "  ############################  "
    ],
    "3": [
      "  ############################  ",
      "  #.........##....##.........#  ",
      "  #.#######.##.##.##.#######.#  ",
      "  #o#######.##.##.##.#######o#  ",
      "  #.##.........##.........##.#  ",
      "  #.##.##.####.##.####.##.##.#  ",
      "  #....##.####.##.####.##....#  ",
      "  ####.##.####.##.####.##.####  ",
      "  ####.##..............##.####  ",
      "T---...####-########-####...---T",
      "  #.##-####-########-####-##.#  ",
      "  #.##---------mm---------##.#  ",
      "  #.####-##-###MM###-##-####.#  ",
      "  #.####-##-#  mm  #-##-####.#  ",
      "  #.-----##-# -mm- #-##-----.#  ",
      "  #.##-####-#      #-####-##.#  ",
      "  #.##-####-########-####-##.#  ",
      "  #.##---------mm---------##.#  ",
      "  #.####-#####-##-#####-####.#  ",
      "  #.####-#####-##-#####-####.#  ",
      "  #......##....##....##......#  ",
      "  ###.##.##.########.##.##.###  ",
      "  ###.##.##.########.##.##.###  ",
      "  #o..##......-mm-......##..o#  ",
      "  #.####.#####.##.#####.####.#  ",
      "  #.####.#####.##.#####.####.#  ",
      "  #......##....##....##......#  ",
      "  #.####.##.########.##.####.#  ",
      "  #.####.##.########.##.####.#  ",
      "  #......##..........##......#  ",
      "  ############################  "
    ]
  }
}
