############################
-------##..........##-------
######-##.########.##-######
######-##.########.##-######
#o...........##...........o#
#.#######.##.##.##.#######.#
#.#######.##.##.##.#######.#
#.##......##.##.##......##.#
#.##.####-##....##-####.##.#
#.##.####-########-####.##.#
#......##-########-##......#
######.##----------##.######
######.##-########-##.######
#......##-#      #-##......#
#.####.##-#      #-##.####.#
#.####.---#      #---.####.#
#...##.##-########-##.##...#
###.##.##----------##.##.###
###.##.####-####-####.##.###
###.##.####-####-####.##.###
###.........####.........###
###.#######.####.#######.###
###.#######.####.#######.###
---....##...----...##....---
###.##.##.########.##.##.###
###.##.##.########.##.##.###
#o..##.......##.......##..o#
#.####.#####.##.#####.####.#
#.####.#####.##.#####.####.#
#..........................#
############################